5 5 5 5 5 5 5 4 4 4 4 4 4 4 4 4
5 5 5 5 5 5 100 100 100 100 100 100 100 100 100 4
5 5 5 5 5 100 100 100 100 100 100 100 100 100 100 4
5 5 100 100 100 100 100 100 100 100 100 100 100 100 100 4
5 100 100 100 100 100 100 100 100 100 100 100 100 100 100 4
4 100 100 100 100 100 100 100 100 100 100 100 100 100 100 4
4 100 100 100 100 100 100 100 100 100 100 100 100 100 100 4
4 100 100 100 100 100 100 100 100 100 100 100 100 100 100 4
4 100 100 100 100 100 100 100 100 100 100 100 100 100 100 4
4 100 100 100 100 100 100 100 100 100 100 100 100 100 100 4
4 100 100 100 100 100 100 100 100 100 100 100 100 100 100 4
4 4 4 4 4 100 100 100 100 100 4 4 4 4 4 4